+-----+---+---+---+---+---+---+---+---+
| y\x | 0 | 1 | 2 | 3 | 4 | 5 | 6 | 7 |
+-----+---+---+---+---+---+---+---+---+
|   0 | S | a | b | q | p | o | n | m |
+-----+---+---+---+---+---+---+---+---+
|   1 | a | b | c | r | y | x | x | l |
+-----+---+---+---+---+---+---+---+---+
|   2 | a | c | c | s | z | E | x | k |
+-----+---+---+---+---+---+---+---+---+
|   3 | a | c | c | t | u | v | w | j |
+-----+---+---+---+---+---+---+---+---+
|   4 | a | b | d | e | f | g | h | i |
+-----+---+---+---+---+---+---+---+---+
